I would like to drastically decrease the amount of time it takes me to clean the house.	J'aimerais diminuer de manière drastique la somme de temps que ça me prend de nettoyer la maison.
If there is nothing near them that needs doing, they are sure to go and find something.	S'il n'y a rien à leur proximité qui doive être fait, il est garanti qu'ils s'en vont trouver quelque chose.
If we don't have a solution, the least we can do is acknowledge that there's a problem.	Si nous n'avons pas de solution, le moins que l'on puisse faire c'est de reconnaître qu'il y a un problème.
In Japan, we still sometimes see someone use an abacus, but not as often as we used to.	Au Japon, on voit toujours parfois quelqu'un utiliser un boulier, mais pas aussi souvent que nous en avions l'habitude.
Last night, we heard sounds of gunshots and screaming on the street outside our window.	La nuit dernière, nous avons entendu des bruits de coups de feu et des cris dans la rue par notre fenêtre.
The eating of delicious food is one of the most intense and poignant pleasures of life.	La consommation de nourriture délicieuse est l'un des plaisirs de la vie les plus intenses et poignants.
The first time you meet people, you should be careful about how near you stand to them.	La première fois que vous rencontrez une personne, vous devriez être attentif à la proximité avec laquelle vous vous tenez par rapport à elle.
The first time you meet people, you should be careful about how near you stand to them.	La première fois que tu rencontres une personne, tu devrais être attentif à la proximité avec laquelle tu te tiens par rapport à elle.
The first time you meet people, you should be careful about how near you stand to them.	La première fois que tu rencontres une personne, tu devrais être attentive à la proximité avec laquelle tu te tiens par rapport à elle.
The first time you meet people, you should be careful about how near you stand to them.	La première fois que vous rencontrez une personne, vous devriez être attentive à la proximité avec laquelle vous vous tenez par rapport à elle.
The first time you meet people, you should be careful about how near you stand to them.	La première fois que vous rencontrez une personne, vous devriez être attentifs à la proximité avec laquelle vous vous tenez par rapport à elle.
The first time you meet people, you should be careful about how near you stand to them.	La première fois que vous rencontrez une personne, vous devriez être attentives à la proximité avec laquelle vous vous tenez par rapport à elle.
To become a professional banjo player, you need to spend thousands of hours practicing.	Pour devenir un joueur professionnel de banjo, il faut passer des milliers d'heures à pratiquer.
Tom put his ear to the door in an effort to overhear what Mary was saying on the phone.	Tom mit son oreille contre la porte afin d'entendre ce que Marie disait au téléphone.
Tom was charged with drunken driving after he was involved in a car accident in Boston.	Tom a été accusé de conduite en état d'ébriété après avoir été impliqué dans un accident de voiture à Boston.
Tom's the kind of person who calls a spade a spade and a lot of people don't like that.	Tom est le genre de personne qui dit les choses comme elles sont et beaucoup de gens n'aiment pas ça.
Amnesty International often organizes public protests in support of political prisoners.	Amnistie internationale organise souvent des manifestations en soutien aux prisonniers politiques.
Eat a live frog every morning, and nothing worse will happen to you the rest of the day.	Mangez une grenouille vivante chaque matin, et rien de pire ne vous arrivera le reste de la journée.
I had to change clothes because what I was wearing wasn't appropriate for the situation.	J'ai dû changer de vêtements parce que ce que je portais ne convenait pas à la situation.
I haven't eaten anything unusual since I've returned home from my trip around the world.	Je n'ai rien mangé d'inhabituel depuis que je suis revenu de mon voyage autour du monde.
I hope all but one of your dreams come true, so you always have something to strive for.	Je vous souhaite que tous vos rêves se réalisent sauf un, de sorte que vous ayez toujours un but à poursuivre.
I said all along that he was not a person to be trusted, but you would not listen to me.	J'ai dit depuis le début qu'il n'était pas une personne digne de confiance, mais tu ne voulais rien entendre.
I saw many people who had no clothes and I saw many clothes which had no people in them.	J'ai vu beaucoup de personnes qui ne portaient pas d'habits sur eux et j'ai vu beaucoup d'habits qui n'étaient portés par personne.
I used to think that only bears hibernate, but the teacher said that turtles do as well.	Je pensais que seuls les ours hibernaient, mais l'institutrice a dit que les tortues le font aussi.
Laughter is like a windshield wiper. It can't stop the rain, but it lets you move ahead.	Le rire, c'est comme un essuie-glace. Il n'arrête pas la pluie, mais il permet d'avancer.
The Catholic Bible contains everything in the Protestant Bible plus several other books.	La Bible catholique contient tout de la Bible protestante additionné de plusieurs autres livres.
The U.S. Secretary of State is trying to broker a ceasefire between the warring parties.	Le Secrétaire d'État étasunien tente de négocier un cessez-le-feu entre les factions en guerre.
These three hours of driving have worn me out. Let's stop at the first rest area we see.	Ces trois heures au volant m'ont éreinté. Arrêtons-nous à la première aire de repos que nous verrons.
Tom got out of the bathtub and dried himself with the new towel that Mary had given him.	Tom sortit de la baignoire et se sécha avec la nouvelle serviette que Marie lui avait donnée.
Tom shaved off his beard and dyed his hair blonde, hoping people wouldn't recognize him.	Tom s'est rasé la barbe et teint les cheveux en blond en espérant que les gens ne le reconnaîtraient pas.
What surprised me most about that accident is how fast the lawyers arrived on the scene.	Ce qui m'a le plus surpris dans cet accident, c'est la rapidité avec laquelle les avocats sont arrivés sur place.
You may not be in the mood to hear this now, but I need to tell you something important.	Peut-être n'es-tu pas d'humeur à entendre ça maintenant, mais je dois de dire quelque chose d'important.
You only really need to sound exactly like a native speaker if you want to become a spy.	On a vraiment besoin de parler exactement comme un natif que lorsque l'on veut devenir un espion.
Almost the only time a fat man loses his temper is when he has been deprived of his food.	Presque la seule fois où un gros homme perd son sang-froid est lorsqu'on le prive de sa nourriture.
An anonymous benefactor bequeathed several hundred thousand dollars to an animal shelter.	Un bienfaiteur anonyme a fait don de plusieurs centaines de milliers de dollars à un refuge animalier.
Because of modern communication and transportation systems, the world is getting smaller.	Grâce aux moyens de communication modernes et aux systèmes de transports, le monde a rétréci.
He has a reputation as being straight as an arrow. He'd never get involved in corruption.	Il a la réputation d'être intègre. Il ne serait jamais impliqué dans de la corruption.
I got together with her mainly because we seemed to share the same feelings about things.	Je me suis mis avec elle principalement pour la raison qu'on semblait partager les mêmes sentiments sur la vie.
I shoot the rabbits in my garden with a squirt gun to keep them away from the vegetables.	Je tire sur les lapins dans mon jardin avec un pistolet à eau pour les tenir éloignés de mes légumes.
I'm getting little pimples on my face. I wonder if I've been getting enough sleep lately.	J'attrape des petits boutons sur le visage. Je me demande si je dors suffisamment ces temps-ci.
If farmers don't make a decent living growing peanuts, they will try growing other crops.	Si les paysans ne retirent pas un revenu décent de la culture des cacahuètes, ils essayeront d'autres cultures.
If the university doesn't have enough students, the administration will cancel the class.	Si l'université ne dispose pas de suffisamment d'étudiants, l'administration annulera le cours.
It's very unlikely that a serious art collector would ever buy anything from that source.	Il est très improbable qu'un collectionneur d'art achète jamais quoi que ce soit de cette origine.
People say that I dream every night, but if I do, I can't ever remember any of my dreams.	Les gens disent que je rêve toutes les nuits mais si je le fais, je n'arrive jamais à me rappeler aucun de mes rêves.
Please don't make me laugh. I did too many sit-ups yesterday and my stomach muscles hurt.	S'il te plait ne me fais pas rire. J'ai fait trop d'abdominaux hier et mes muscles ventraux me font mal.
She advised him to see the dentist, but he said that he didn't have enough time to do so.	Elle lui recommanda de voir le dentiste mais il déclara qu'il ne disposait pas de suffisamment de temps pour le faire.
She advised him to see the dentist, but he said that he didn't have enough time to do so.	Elle lui a recommandé de voir le dentiste mais il a déclaré qu'il ne disposait pas de suffisamment de temps pour le faire.
Since I have no children, I have more time to spend doing volunteer work than parents do.	Comme je n'ai pas d'enfants, je dispose de davantage de temps que les parents à consacrer à des travaux volontaires.
The government will provide interest-free loans to firms that participate in the program.	Le gouvernement allouera des prêts sans intérêts aux sociétés qui participent au programme.
The poor acoustics in the hall severely affected the audience's enjoyment of the concert.	La médiocre acoustique de la salle a sérieusement affecté le plaisir que le public a retiré du concert.
They say that in America anyone can become president, but perhaps that's not really true.	On dit qu'aux États-Unis d'Amérique, n'importe qui peut devenir Président, mais ce n'est peut-être pas réellement vrai.
Tom certainly had a point when he said we should allow more time to complete the project.	Tom avait certainement un but quand il a dit que nous devrions permettre plus de temps pour compléter le projet.
Tom killed Mary because he found out she had started the fire that had killed his family.	Tom tua Mary parce qu'il a découvert qu'elle était à l'origine du feu qui ravagea sa famille.
Tom killed Mary because he found out she had started the fire that had killed his family.	Tom tua Mary parce qu'il a découvert qu'elle était à l'origine du feu qui tua sa famille.
Tom killed Mary because he found out she had started the fire that had killed his family.	Tom a tué Mary parce qu'il a découvert qu'elle était à l'origine de l'incendie qui a tué sa famille.
"Everything accomplished starts with the dream of it," is a saying we all know to be true.	« Tout ce qui est accompli commence par sa projection » est un dicton dont nous connaissons tous la vérité.
"Why have you started learning to play the piano?" "Because I want to be a music teacher."	"Pourquoi avez-vous commencé à apprendre le piano ?" "Parce que je veux devenir professeur de musique."
Although most islands in the ocean have been mapped, the ocean floor is generally unknown.	Bien que la plupart des îles de l'océan aient été cartographiées, les fonds océaniques sont généralement inconnus.
Bodybuilding is his hobby so he has a very firm tight body with lots of muscle definition.	La musculation est son passe-temps c'est pourquoi il a un corps très ferme avec des muscles bien découpés.
I always thought that a stroke was one of nature's ways to tell you that it's time to die.	J'ai toujours pensé qu'un infarctus était la manière dont la nature t'indique qu'il est temps de mourir.
I am staying with my uncle for the time being, but later I will move to a small apartment.	Je réside avec mon oncle pour le moment, mais plus tard j'emménagerai dans un petit appartement.
I began driving our tractor when I was 12 years old to help my father out at harvest time.	Je conduisais notre tracteur dès l'âge de 12 ans pour aider mon père pendant la moisson.
I know some of you want to go back to the way things were, but that's not going to happen.	Je sais que certains d'entre vous veulent revenir aux choses telles qu'elles étaient mais ça ne va pas se produire.
I know some of you want to go back to the way things were, but that's not going to happen.	Je sais que certaines d'entre vous veulent revenir aux choses telles qu'elles étaient mais ça ne va pas se produire.
I know some of you want to go back to the way things were, but that's not going to happen.	Je sais que certains d'entre vous veulent revenir aux choses telles qu'elles étaient mais ça ne va pas arriver.
I know some of you want to go back to the way things were, but that's not going to happen.	Je sais que certaines d'entre vous veulent revenir aux choses telles qu'elles étaient mais ça ne va pas arriver.
I'm a non-native speaker of English and realize there is a lot that I still need to learn.	Je suis un locuteur non-natif de l'anglais et je prends conscience que j'ai encore beaucoup à apprendre.
If Cleopatra's nose had been shorter, the whole face of the world would have been changed.	Le nez de Cléopâtre, s'il eût été plus court, toute la face de la terre aurait changé.
Most of the time, he doesn't get to sleep before two or even three o'clock in the morning.	La plupart du temps, il ne s'endort pas avant deux voire trois heures du matin.
One out of 455 women doesn't realize she's pregnant until the twentieth week of pregnancy.	Un femme sur quatre-cent-cinquante-cinq ne prend pas conscience qu'elle est enceinte avant la vingtième semaine de grossesse.
She took advantage of our hospitality and stayed a whole month without paying us anything.	Elle profita de notre hospitalité et resta un mois entier sans rien nous payer.
Sorry, but it all came about so suddenly that I haven't got a handle on the situation yet.	Désolé, mais tout cela s'est produit si soudainement que je n'ai pas encore pu me charger de la situation.
The man who is constantly making decisions and being compelled to alter them gets nowhere.	L'homme qui prend constamment des décisions et est forcé de les altérer ne va nulle part.
The police told the demonstrators that they'd be arrested if they didn't move immediately.	La police indiqua aux manifestants qu'ils seraient arrêtés s'ils ne bougeaient pas immédiatement.
To improve your fluency, you should try speaking with native speakers as often as you can.	Pour améliorer votre fluidité, vous devriez essayer de parler avec des locuteurs natifs le plus souvent possible.
To reduce misunderstandings we should learn the techniques for communicating successfully.	Afin de diminuer les incompréhensions, nous devons apprendre les techniques pour communiquer avec succès.
Tom doesn't like Mary. However, she doesn't particularly care whether he likes her or not.	Tom n'aime pas Mary. Cependant, elle ne se soucie pas particulièrement de savoir si il l'aime ou non.
Tom has enough money to buy any computer in this store. He just needs to decide which one.	Tom a assez d'argent pour acheter n'importe quel ordinateur de ce magasin. Il a seulement besoin de décider lequel.
When Tom was a kid, he became obsessed with the girl who lived across the street from him.	Lorsque Tom était gosse, il est devenu obsédé par la jeune fille qui habitait en face de chez lui.
You're the only person I know besides me who is actually interested in this kind of thing.	Vous êtes la seule personne que je connaisse à part moi qui soit réellement intéressée par ce genre de truc.
You're the only person I know who doesn't take some kind of medicine at least once a week.	Tu es la seule personne que je connaisse qui ne prend pas un médicament ou un autre au moins une fois par semaine.
A study found that almost 10% of men were obese in 2008. That was up from about 5% in 1980.	Une étude a montré que presque dix pour cent des hommes étaient obèses en deux-mille-huit. C'était en augmentation en partant d'environ cinq pour cent en mille-neuf-cent-quatre-vingt.
All of your accusations are without foundation. She's innocent and we're going to prove it.	Toutes vos accusations sont sans fondement, elle est innocente et nous le prouverons !
As a rule, I prefer people who deal with matters of this kind directly with those involved.	En règle générale, je préfère les gens qui traitent ce genre de choses directement avec les personnes concernées.
At the party, one of his political opponents humiliated him in the presence of many guests.	À la fête, un de ses opposants politiques l'a humilié en présence de nombreux invités.
Don't come to me now with that. You should have said something when it originally happened.	Ne viens pas me voir maintenant pour ça. Tu aurais dû en parler dès que c'est arrivé.
He is likely to have a book and a cracker at his meals--and then forget to eat the cracker!	Il a des chances d'avoir un livre et un biscuit pour ses repas...et puis d'oublier de manger le biscuit !
I like this picture, not just because it is famous, but because it really is a masterpiece.	J'aime ce tableau, pas seulement pour sa renommée, mais parce que c'est vraiment un chef-d'œuvre.
I suggest you have a native speaker read over your report to make sure there are no errors.	Je suggère que tu fasses relire ton rapport par un natif, pour t'assurer qu'il n'y a pas d'erreurs.
I'd like to ask you a question, but if this is a bad time, I can come back at another time.	J'aimerais vous poser une question mais si le moment n'est pas propice, je peux revenir à un autre moment.
I'd like to ask you a question, but if this is a bad time, I can come back at another time.	J'aimerais te poser une question mais si le moment n'est pas propice, je peux revenir à un autre moment.
The best parents of all are those who allow their children to follow their natural talents.	Les meilleurs de tous les parents sont ceux qui permettent à leurs enfants de suivre leurs talents naturels.
The important point to note is that both parties offered similar solutions to this problem.	Le point important à noter est que les deux groupes ont proposé des solutions similaires à ce problème.
The rabbit stood in the middle of the road, mesmerized by the lights of the oncoming truck.	Le lapin se tenait au milieu de la route, hypnotisé par les phares du camion qui arrivait.
There were many things that needed my attention, so I didn't get home until after midnight.	Il y avait de nombreuses choses qui requéraient mon attention, je ne suis donc rentré chez moi qu'après minuit.
There were many things that we wanted to do, but we never got around to doing many of them.	Il y avait de nombreuses choses que nous voulions faire, mais nous ne sommes pas parvenus à faire beaucoup d'entre elles.
There were many things that we wanted to do, but we never got around to doing many of them.	Il y avait de nombreuses choses que nous voulions faire, mais nous ne sommes pas parvenues à faire beaucoup d'entre elles.
This figure is supposed to represent Marilyn Monroe, but I don't think it does her justice.	Cette figurine est censée représenter Marilyn Monroe, mais je ne trouve pas qu'elle lui rende justice.
67% of those who never smoked said they worried about the health effects of passive smoking.	67% de ceux qui n'ont jamais fumé ont dit qu'ils s'inquiétaient des effets sur la santé de la fumée passive.
"When poverty comes in the door, love flies out the window" is a saying as old as it is sad.	« Lorsque la pauvreté passe la porte, l'amour s'envole par la fenêtre » est un adage aussi vieux que triste.
A "renovator's dream" in real estate parlance generally means that the place is a real dump.	Dans le jargon de l'immobilier, un « rêve pour bricoleur » signifie généralement que l'endroit est une vraie décharge.
A slightly lower interest rate could save thousands of dollars over the life of a home loan.	Un taux d'intérêt un peu plus bas peut épargner des milliers de dollars au cours de la durée d'un prêt immobilier.
According to legend, ghosts would appear in that forest, so people would not set foot there.	Selon la légende, cette forêt serait hantée, aussi les gens n'y mettaient pas les pieds.
After I graduated from college, I moved back home and lived with my parents for three years.	Après avoir été diplômé de l'école, j'ai de nouveau emménagé chez moi et vécu avec mes parents pendant trois ans.
After I graduated from college, I moved back home and lived with my parents for three years.	Après avoir été diplômée de l'école, j'ai de nouveau emménagé chez moi et vécu avec mes parents durant trois ans.
Children often want to do things that are dangerous without knowing that they are dangerous.	Les enfants veulent souvent faire des choses qui sont dangereuses, sans savoir qu'elles sont dangereuses.
Even though my friend was a vegetarian, I didn't tell him that the soup had some meat in it.	Bien que mon ami fut végétarien, je ne lui dis pas que la soupe contenait de la viande.
Even though my friend was a vegetarian, I didn't tell him that the soup had some meat in it.	Bien que mon ami soit végétarien, je ne lui ai pas dit que la soupe contenait de la viande.
He writes a daily journal, and that inspired me to try doing the same thing, but in English.	Il tient un journal intime, et cela m'a encouragé à faire pareil, mais en anglais.
It should be stressed that we are often influenced by advertising without being aware of it.	Il y a lieu de souligner que nous sommes souvent inconsciemment influencés par la publicité.
My sister will have been studying English for ten years when she graduates from her college.	Ma sœur aura étudié l'anglais durant dix ans quand elle obtiendra son diplôme de l'université.
Numbers that can be expressed as fractions of two whole numbers are called rational numbers.	On dit « rationnel » un nombre qui s'exprime en tant que fraction de deux entiers relatifs.
She asked him to help her father clean the garage, but he said that he was too busy to help.	Elle lui demanda d'aider son père à nettoyer le garage mais il déclara qu'il était trop occupé pour le faire.
She asked him to help her father clean the garage, but he said that he was too busy to help.	Elle lui a demandé d'aider son père à nettoyer le garage mais il a déclaré qu'il était trop occupé pour le faire.
The bank rate cut is expected to relieve the severe financial squeeze that has hit industry.	On espère que la baisse des taux bancaires soulagera le sévère resserrement financier qui a frappé l'industrie.
The cat was lying stretched out at full length in the sunlight streaming through the window.	Le chat était étendu de tout son long dans la lumière du soleil, rayonnant par la fenêtre.
When we started out, we realized that if we didn't have a good product, we wouldn't succeed.	Lorsque nous avons commencé, nous avons réalisé que si nous ne disposions pas d'un bon produit, nous ne réussirions pas.
You probably eat genetically modified fruits and vegetables all the time without knowing it.	Vous mangez probablement tout le temps des fruits et des légumes génétiquement modifiés sans le savoir.
A little knowledge of Spanish will go a long way toward making your trip to Mexico enjoyable.	Avoir quelques notions d'espagnol contribuera largement à rendre ton séjour au Mexique plus agréable.
After he came back from service in Afghanistan, Tom was plagued by flashbacks and nightmares.	Après son retour de services en Afghanistan, Tom était tourmenté par des flashbacks et des cauchemars.
Certainly he is handsome and intelligent, but there is something about him that I can't like.	Il est certainement beau et intelligent mais il y a quelque chose en lui que je n'arrive pas à aimer.
I never thought this rubber band would come in handy when I put it in my pocket this morning.	Je n'ai jamais pensé que cet élastique s'avérerait utile lorsque je l'ai mis dans ma poche ce matin.
Right now, we have blueberries, blackberries, cherries, strawberries, peaches and nectarines.	À l'heure actuelle, nous avons des myrtilles, des mûres, des cerises, des fraises, des pêches et des nectarines.
Rwandan rebels are pushing their offensive south as fighting continues in the capital Kigali.	Alors que les combats continuent dans la capitale Kigali, les forces antigouvernementales rwandaises poussent leur offensive vers le sud.
Since this is your neck of the woods, maybe you can tell us where to find a good pizza joint.	Comme c'est ton bled, peut-être peux-tu nous dire où trouver une bonne pizzeria.
Since this is your neck of the woods, maybe you can tell us where to find a good pizza joint.	Comme c'est votre bled, peut-être pouvez-vous nous dire où trouver une bonne pizzeria.
The man in charge of the merry-go-round decided to make sure everything was working properly.	L'homme en charge du manège décida de s'assurer que tout fonctionnait correctement.
The only thing that matters is whether or not your teacher thinks your report is good enough.	La seule chose qui compte vraiment est si oui ou non ton professeur pense que ton exposé est assez bon.
The only thing that matters is whether or not your teacher thinks your report is good enough.	La seule chose qui compte vraiment est si oui ou non votre professeur pense que votre exposé est assez bon.
To laugh at everything that is done or said is stupid, but not to laugh is even more foolish.	Rire de tout ce qui est dit ou fait est idiot mais ne pas rire est encore plus bête.
Tom insisted he hadn't been drinking, but his slurred speech and unsteady gait gave him away.	Tom a insisté qu'il n'avait pas bu, mais son élocution et sa démarche instable le trahissait.
We keep our most interesting thoughts and the most interesting side of ourselves hidden away.	Nous gardons secrètes nos pensées les plus intéressantes et la part la plus intéressante de nous-mêmes.
When we started out, our band could only find small clubs in small cities that would hire us.	Quand nous avons démarré, notre groupe ne pouvait trouver que des petites salles dans de petites villes pour nous engager.
A business cycle is a recurring succession of periods of prosperity and periods of depression.	Le cycle d'une entreprise est une succession de périodes de prospérité et de dépression.
Abraham Lincoln, the 16th president of the United States, was born in a log cabin in Kentucky.	Abraham Lincoln, le 16e Président des États-Unis, est né dans une fuste au Kentucky.
Abraham Lincoln, the 16th president of the United States, was born in a log cabin in Kentucky.	Abraham Lincoln, le 16e Président des États-Unis, est né dans une cabane au Kentucky.
Bear in mind that, under such circumstances, we have no alternative but to find another buyer.	Comprenez bien que dans de telles circonstances, nous n'avons pas d'autres alternatives que de trouver un autre acheteur.
By the end of the century, the earth will have experienced a dramatic increase in temperature.	D'ici la fin du siècle, la terre aura fait l'expérience d'une alarmante augmentation de la température.
I can't help but feel that if we had gotten to know each other better, we'd have been friends.	Je ne peux pas m'empêcher de penser que si nous avions mieux fait connaissance, nous aurions été amis.
I can't help but feel that if we had gotten to know each other better, we'd have been friends.	Je ne peux pas m'empêcher de penser que si nous avions mieux fait connaissance, nous aurions été amies.
I realize that this may sound crazy, but I think I've fallen in love with your younger sister.	Je me rends compte que ça a l'air fou, mais je pense que je suis tombé amoureux de votre sœur cadette.
I realize that this may sound crazy, but I think I've fallen in love with your younger sister.	Je me rends compte que ça a l'air fou, mais je pense que je suis tombé amoureux de ta sœur cadette.
I tried explaining the algebra homework to him, but it just went in one ear and out the other.	Je tentai de lui expliquer le devoir d'algèbre, mais ça rentra juste par une oreille et ça ressortit pas l'autre.
If camping doesn't float your boat, then you probably don't want to spend the weekend with us.	Si camper n'est pas ton truc, alors tu ne veux probablement pas passer le week-end avec nous.
If we were supposed to talk more than listen, we would have been given two mouths and one ear.	Si on était censé parler plus qu'on écoute, on serait doté de deux bouches et d'une seule oreille.
If you want to lose weight, the best thing to do is to eat properly and get a lot of exercise.	Si vous voulez perdre du poids, la meilleure chose à faire est de manger proprement et faire beaucoup d'exercice.
In conversation, one is likely to find out certain things about the other person quite easily.	Dans une conversation, il est probable que quelqu'un découvre assez facilement certaines choses à propos de l'autre personne.
In the United States, it takes a minimum of eight years of college to become a medical doctor.	Aux USA, devenir médecin prend un minimum de huit années d'études universitaires.
It looks like the question was too easy for you. Next time, I'll have to make it a bit harder.	Il semble que la question était trop facile pour toi. La prochaine fois, je devrai en faire une un peu plus difficile.
It's my fault that the cake was burned. I was talking on the phone and didn't notice the time.	Le gâteau a brûlé par ma faute. J'étais au téléphone et n'ai pas fait attention à l'heure.
No person achieves success or happiness when compelled to do what he naturally dislikes to do.	Personne n'atteint au succès ou au bonheur en étant forcé de faire ce qu'il répugne naturellement à faire.
The data cited in King's research is taken from UNESCO's 1970 white paper on world population.	Les données citées dans l'enquête de King proviennent du livre blanc de l'UNESCO de 1970 sur la population mondiale.
The wizened, old sorcerer took me under his wing and taught me everything he knew about magic.	Le vieux sorcier ratatiné me prit sous son aile et m'enseigna tout ce qu'il savait de la magie.
There's nothing more annoying than a group of young girls all trying to talk at the same time.	Il n'y a rien de plus embêtant qu'un groupe de jeunes filles qui essayent toutes de parler en même temps.
There's nothing more annoying than a group of young girls all trying to talk at the same time.	Il n'y a rien de plus embêtant qu'un groupe de jeunes filles qui, toutes, essaient de parler en même temps.
We very often only come to appreciate someone or our relationship with them when we lose them.	Nous finissons très souvent par apprécier quelqu'un ou notre relation avec lui seulement lorsque nous le perdons.
When you meet someone for the first time, be careful about how close you stand to that person.	Lorsque vous rencontrez une personne pour la première fois, soyez attentif à la distance à laquelle vous vous en tenez.
When you meet someone for the first time, be careful about how close you stand to that person.	Lorsque tu rencontres une personne pour la première fois, sois attentif à la distance à laquelle tu te tiens d'elle.
When you meet someone for the first time, be careful about how close you stand to that person.	Lorsque tu rencontres une personne pour la première fois, sois attentive à la distance à laquelle tu te tiens d'elle.
When you meet someone for the first time, be careful about how close you stand to that person.	Lorsque vous rencontrez une personne pour la première fois, soyez attentifs à la distance à laquelle vous vous en tenez.
When you meet someone for the first time, be careful about how close you stand to that person.	Lorsque vous rencontrez une personne pour la première fois, soyez attentive à la distance à laquelle vous vous tenez d'elle.
When you meet someone for the first time, be careful about how close you stand to that person.	Lorsque vous rencontrez une personne pour la première fois, soyez attentives à la distance à laquelle vous vous en tenez.
You don't know until you've had a child what pain you can feel when something happens to them.	Vous ne savez pas, jusqu'à ce que vous ayez un enfant, quelle douleur vous pouvez ressentir lorsque quelque chose leur arrive.
A motel is like a hotel only much smaller and is used mostly by people traveling by automobile.	Un motel ressemble à un hôtel, mais c'est plus petit et utilisé principalement par des gens qui voyagent en voiture.
As soon as I can get my son to scan our family photos, I'll upload some of them to our website.	Dès que je parviens à faire scanner nos photos de famille par mon fils, j'en téléchargerai sur notre site web.
For some reason, people have been avoiding me like the plague ever since I got back from India.	Pour une raison quelconque, les gens m'ont évité comme la peste depuis que je suis revenu d'Inde.
For some reason, people have been avoiding me like the plague ever since I got back from India.	Pour une raison quelconque, les gens m'ont évitée comme la peste depuis que je suis revenue d'Inde.
I think that Tom and only Tom can do it. However, some people think that Mary could do it, too.	Je crois que Tom seul peut le faire. Toutefois, il y a ceux qui croient que Marie en est également capable.
It's customary for waiters and waitresses to introduce themselves using only their first names.	Il est usuel chez les serveurs et les serveuses de se présenter en n'employant que leur prénom.
Mary likes to wear clothes with vertical stripes, because she heard they make you look thinner.	Marie aime porter des vêtements avec des rayures verticales, car elle a entendu dire que ça amincissait.
Professional translators quite often specialize in just one field, for example law or medicine.	Les traducteurs professionnels se spécialisent souvent dans un seul domaine, par exemple le droit ou la médecine.
The U.S. Department of Health says people should exercise at least two and a half hours a week.	Le Département de la Santé des USA déclare que les gens devraient faire de l'exercice au moins deux heures et demie par semaine.
The world was on the very brink of nuclear war during the Cuban Missile Crisis in October 1962.	Le monde était tout au bord d'une guerre nucléaire, lors de la crise des missiles de Cuba, en octobre dix-neuf-cent-soixante-deux.
Tom did not want to throw anything away because he thought that he might need it in the future.	Tom ne voulait rien jeter parce qu'il pensait qu'il pourrait en avoir besoin à l'avenir.
We have considered your proposal, and we have decided that we are not able to reduce the price.	Nous avons pris votre proposition en considération et nous avons décidé que nous ne sommes pas en mesure de réduire le prix.
We humans have a great way of twisting facts to fit our conclusion as soon as we have made one.	Nous les humains avons une grande disposition à tordre les faits pour qu'ils s'ajustent à notre conclusion dès lors que nous en avons formé une.
What is considered impolite in one language may not be considered impolite in another language.	Ce qui est considéré comme impoli dans une langue peut ne pas l'être dans une autre.
When out at sea, to keep the fish that is caught from spoiling, it is immediately refrigerated.	En mer, pour empêcher le poisson qui est capturé de se gâter, il est immédiatement réfrigéré.
Acidification of the ocean will, in time, threaten the very existence of the Great Barrier Reef.	L'acidification de l'océan menacera, à un moment, l'existence même de la Grande Barrière de Corail.
Going to church doesn't make you a Christian any more than standing in a garage makes you a car.	Aller à l'église ne fait pas davantage de toi un Chrétien que te tenir dans un garage ne fait de toi une voiture.
I thought a bunch of people would go water skiing with us, but absolutely no one else showed up.	Je pensais qu'une poignée de gens serait venue faire du ski-nautique avec nous, mais absolument personne ne se manifesta.
I thought doing this would be easy, but we've been working all day and we're still not finished.	Je pensais que faire cela serait facile, mais nous avons travaillé toute la journée et nous n'avons pas encore terminé.
It's not uncommon for people to give fake personal information when registering to use websites.	Ce n'est pas inhabituel pour les gens de donner de fausses informations quand ils s'inscrivent à des sites web.
Most of the plain, simple, everyday things he desires can be secured by people of average means.	La plupart des choses ordinaires, simples et quotidiennes qu'il désire peut être obtenue par des gens au revenu moyen.
Mozart wrote brilliant, complex musical compositions as easily as you or I would write a letter.	Mozart a écrit de brillantes et complexes compositions musicales aussi facilement que toi ou moi écririons une lettre.
People can begin to love when they choose, but they have no choice when it comes to ending love.	Les gens peuvent se mettre à aimer lorsqu'ils le veulent mais ils n'ont pas de choix lorsqu'il s'agit d'arrêter d'aimer.
She would often bring home table scraps from the restaurant where she worked to feed to her dog.	Elle ramenait souvent des restes du restaurant où elle travaillait pour donner à manger à son chien.
Since I haven't received an answer, I was wondering if maybe my mail never got delivered to you.	Étant donné que je n'ai reçu aucune réponse, je me demandais s'il était possible que mon courrier ne vous ait jamais été livré.
To have more than one problem before him at one time makes him irritable, upset and exasperated.	Avoir devant lui plus d'un problème à la fois le rend irritable, contrarié et exaspéré.
You will receive a confirmation email after your account has been activated by an administrator.	Vous allez recevoir une confirmation par courriel après l'activation de votre compte par un administrateur.
Blood spatter analysis plays an important role in determining what has happened at a crime scene.	L'analyse des éclaboussures de sang joue un rôle important dans la détermination de ce qui s'est produit sur un lieu de crime.
Carbon monoxide is a poisonous substance formed by the incomplete combustion of carbon compounds.	Le monoxyde de carbone est une substance mortelle qui résulte de la combustion incomplète de composés carbonés.
Culture plays a dynamic role in shaping an individual's character, attitude, and outlook on life.	La culture joue un rôle actif dans la formation chez un individu du caractère, de l'attitude et du regard sur la vie.
Fewer and fewer people are working to support more and more people living on government benefits.	De moins en moins de gens travaillent à assister de plus en plus de gens vivant des subsides du gouvernement.
Hackers were able to break into the company's computer system and undermine its network security.	Des pirates informatiques ont été en mesure de s'introduire dans le système informatique de l'entreprise et de saper la sécurité de son réseau.
He is usually straightforward and sincere and thereby gains the confidence of those who meet him.	Il est d'ordinaire direct et sincère et gagne ainsi la confiance de ceux qui le rencontrent.
I have a lot to do today, so if you don't mind, I'd like to have this discussion at another time.	J'ai fort à faire aujourd'hui alors, si ça ne vous dérange pas, j'aimerais avoir cette discussion une autre fois.
I have a lot to do today, so if you don't mind, I'd like to have this discussion at another time.	J'ai beaucoup à faire aujourd'hui alors, si ça ne te dérange pas, j'aimerais avoir cette discussion une autre fois.
I have no strong opinion about the matter, so whatever the majority thinks is good is OK with me.	Je n'ai pas d'opinion tranchée sur la question, donc quoi que pense la majorité me convient.
If you calculate the electric field using this equation, the result comes out like the following.	En utilisant cette équation pour calculer le champ électrique, le résultat vient comme ci-après.
If you want to achieve the kind of success that I think you do, then you'll have to study harder.	Si tu veux obtenir le genre de succès que je pense que tu veux, alors tu devras étudier davantage.
When you have eliminated the impossible, whatever remains, however improbable, must be the truth.	Lorsque l'on a éliminé l'impossible, tout ce qui reste, quoiqu'improbable, doit être la vérité.
Apart from a filing tray full of papers on the desk, everything else in the room was on the floor.	En dehors d'une classeur plein de papiers sur le bureau, tout le reste dans la pièce était par terre.
From personal experience, I know that any encounter with him will leave a bad taste in your mouth.	Selon mon expérience personnelle, je sais que la moindre rencontre avec lui vous laisse un mauvais goût dans la bouche.
From personal experience, I know that any encounter with him will leave a bad taste in your mouth.	Selon mon expérience personnelle, je sais que la moindre rencontre avec lui te laisse un mauvais goût dans la bouche.
From personal experience, I know that any encounter with him will leave a bad taste in your mouth.	Selon mon expérience personnelle, je sais que la moindre rencontre avec lui laisse un mauvais goût dans la bouche.
He had gone there to help garbage workers strike peacefully for better pay and working conditions.	Il est allé là-bas pour aider les éboueurs à se mettre en grève pacifiquement pour réclamer un salaire plus élevé et de meilleures conditions de travail.
I heard that one way to stay healthy is to avoid eating any food with unpronounceable ingredients.	J'ai entendu dire qu'une manière de rester en bonne santé est d'éviter de manger de la nourriture contenant des ingrédients imprononçables.
I think it's unlikely that the next version of Windows will come out before the end of this month.	Je crois qu'il est improbable que la prochaine version de Windows sorte avant la fin de ce mois-ci.
I wasn't really doing much of anything, so I decided it'd be a good idea to walk down to the cafe.	Je foutais pas grand-chose, alors j'ai décidé que ce serait une bonne idée de marcher jusqu'au café.
I've kept my weight down even though many of my friends have gained weight as they've grown older.	J'ai contenu mon poids alors même que beaucoup de mes amies en ont gagné tandis qu'elles prenaient de l'âge.
Sooner or later, every parent has to have a talk with their children about the birds and the bees.	Tôt ou tard, tous les parents doivent avoir une conversation avec leurs enfants au sujet des roses et des choux.
Tom told Mary that he thought a hippopotamus could run at a speed of about 30 kilometers per hour.	Tom a dit à Mary qu'il pensait qu'un hippopotame pouvait courir à une vitesse d'environ trente kilomètres par heure.
When your friends begin to flatter you on how young you look, it's a sure sign you're getting old.	Quand vos amis commencent à vous dire que vous ne faites pas votre âge, c'est le signe infaillible que vous vieillissez.
You know that your English is good when people stop complimenting you on how good your English is.	Vous savez que votre anglais est bon lorsque les gens arrêtent de vous en complimenter.
Chinese officials say economic growth has dropped to a three-year low because of the world economy.	Les officiels chinois disent que la croissance économique est tombée à son plus bas niveau depuis trois ans en raison de l'économie mondiale.
Girls begin puberty around the ages of ten to eleven, and boys around the ages of eleven to twelve.	Les filles commencent leur puberté aux environs de dix ou onze ans et les garçons autour de onze ou douze.
I can't believe that you aren't at least willing to consider the possibility of other alternatives.	Je n'arrive pas à croire que vous ne soyez pas au moins disposé à envisager d'autres possibilités.
I can't believe that you aren't at least willing to consider the possibility of other alternatives.	Je n'arrive pas à croire que vous ne soyez pas au moins disposée à envisager d'autres possibilités.
I can't believe that you aren't at least willing to consider the possibility of other alternatives.	Je n'arrive pas à croire que vous ne soyez pas au moins disposés à envisager d'autres possibilités.
I can't believe that you aren't at least willing to consider the possibility of other alternatives.	Je n'arrive pas à croire que vous ne soyez pas au moins disposées à envisager d'autres possibilités.
I can't believe that you aren't at least willing to consider the possibility of other alternatives.	Je n'arrive pas à croire que tu ne sois pas au moins disposé à envisager d'autres possibilités.
I can't believe that you aren't at least willing to consider the possibility of other alternatives.	Je n'arrive pas à croire que tu ne sois pas au moins disposée à envisager d'autres possibilités.
I can't believe that you aren't at least willing to consider the possibility of other alternatives.	Je n'arrive pas à croire que tu ne sois pas tout au moins disposé à envisager d'autres possibilités.
I can't believe that you aren't at least willing to consider the possibility of other alternatives.	Je n'arrive pas à croire que tu ne sois pas tout au moins disposée à envisager d'autres possibilités.
I can't believe that you aren't at least willing to consider the possibility of other alternatives.	Je n'arrive pas à croire que vous ne soyez pas tout au moins disposées à envisager d'autres possibilités.
I can't believe that you aren't at least willing to consider the possibility of other alternatives.	Je n'arrive pas à croire que vous ne soyez pas tout au moins disposés à envisager d'autres possibilités.
I can't believe that you aren't at least willing to consider the possibility of other alternatives.	Je n'arrive pas à croire que vous ne soyez pas tout au moins disposée à envisager d'autres possibilités.
I can't believe that you aren't at least willing to consider the possibility of other alternatives.	Je n'arrive pas à croire que vous ne soyez pas tout au moins disposé à envisager d'autres possibilités.
I told you not to play your cello late at night, but you did and now the neighbors have complained.	Je t'avais dit de ne pas jouer de violoncelle tard la nuit, mais tu l'as fait et maintenant les voisins se sont plaints.
I'm begging you. Don't make me laugh. I did too many sit-ups yesterday and my stomach muscles hurt.	Je t'en supplie. Ne me fais pas rire. J'ai fait trop d'abdominaux hier et mes muscles ventraux me font mal.
If you were a spy trying to pass as a native speaker and said it that way, you'd likely get caught.	Si tu étais un espion essayant de te faire passer pour un natif et que tu le disais de cette manière, il est probable que tu te ferais prendre.
It never occurred to me to take a picture of how the garden looked before we started pulling weeds.	Il ne m'est jamais venu à l'esprit de prendre une photo de ce que le jardin avait l'air, avant que nous ne commencions à arracher les mauvaises herbes.
No matter how busy Tom gets, he never forgets to write an email to his mother at least once a week.	Même si Tom est occupé, il n'oublie jamais d'écrire un courriel à sa mère au moins une fois par semaine.
Since in this organization they're all chiefs and no Indians, it's a wonder any decisions get made.	Vu que dans cette organisation, il n'y a que des chefs et pas d'indiens, c'est un miracle que quelque décision soit effectuée.
Some people clung to tree branches for several hours to avoid being washed away by the floodwaters.	Certaines personnes étaient accrochées à des branches d'arbres durant plusieurs heures, afin d'éviter d'être emportées par les eaux.
The handyman was supposed to arrive at twelve noon, but got stuck in a traffic jam for a few hours.	Le réparateur devait arriver à midi, mais il s'est retrouvé coincé dans des bouchons pendant plusieurs heures.
The press has been hounding the president nonstop about reneging on his promise not to raise taxes.	La presse n'a eu de cesse de pourchasser le Président au sujet de son renoncement à sa promesse de ne pas augmenter les impôts.
Tom did everything within his power to save the children that were trapped in the burning building.	Tom fit tout ce qu'il put pour sauver les enfants pris au piège dans le bâtiment en flammes.
You can accelerate as much as you want, but since the car's in neutral, we won't be going anywhere.	Tu peux toujours accélérer, vu qu'on est au point mort, on va aller nulle part.
You will never get far without the co-operation, confidence and comradeship of other men and women.	Vous n'irez jamais loin sans la coopération, la confiance et la camaraderie des autres hommes et femmes.
A high proportion of crime in any country is perpetrated by young males in their teens and twenties.	Une proportion élevée des crimes, dans quelque pays que ce soit, est perpétrée par de jeunes individus mâles, avant leurs trente ans.
Giving up smoking is the easiest thing in the world. I know because I've done it thousands of times.	S'arrêter de fumer, c'est ce qu'il y a de plus facile. Je le sais bien pour l'avoir fait moi-même des milliers de fois.
He insists on things being done in the most efficient way and he usually does them that way himself.	Il insiste pour que les choses soient réalisées de la manière la plus efficace et les réalise lui-même de cette façon.
I think it's unlikely that aliens similar to what we see in the movies have ever visited our planet.	Je crois qu'il est improbable que des extraterrestres comme ceux que nous voyons dans les films aient jamais visité notre planète.
If you spend too much time in the sun without putting on sunscreen, you are likely to get a sunburn.	Si tu passes trop de temps au soleil sans mettre de crème solaire, il est probable que tu attrapes un coup de soleil.
If you spend too much time in the sun without putting on sunscreen, you are likely to get a sunburn.	Si vous passez trop de temps au soleil sans mettre de crème solaire, il est probable que vous attrapiez un coup de soleil.
If you spend too much time in the sun without putting on sunscreen, you are likely to get a sunburn.	Si on passe trop de temps au soleil sans mettre de crème solaire, il est probable qu'on attrape un coup de soleil.
The bank had the gall to charge a late fee for a payment held up when their online services crashed.	La banque a eu le culot d'imputer des frais de retard pour un paiement retardé lorsque leur service en ligne s'est planté.
There have been a lot of complaints from consumers that our products don't last as long as we claim.	Il y a eu de nombreuses réclamations de consommateurs sur le fait que nos produits ne durent pas aussi longtemps que nous le prétendons.
Unless you started learning English as a child, you're unlikely to ever sound like a native speaker.	À moins d'avoir commencé, enfant, à apprendre l'anglais, il est improbable de jamais passer pour un locuteur natif.
You get tired of a beautiful woman after three days. You get used to an ugly woman after three days.	On se fatigue d'une belle femme après trois jours. On s'habitue à une femme laide au bout de trois jours.
As an Englishman, he is particularly sensitive to the differences between English and American usage.	En tant qu'Anglais, il est particulièrement sensible aux différences entre les usages anglais et étasunien.
Before I get out of bed, I spend a little time thinking about what I'll be doing the rest of the day.	Avant de sortir du lit, je passe un peu de temps à songer à ce que je vais faire le reste de la journée.
From the position of the wounds on the body, the police could tell that the attacker was left-handed.	À partir de la position des blessures sur le corps, la police a pu déclarer que l'attaquant était gaucher.
I know it doesn't look like it, but I've actually gotten rid of a lot of stuff out of the spare room.	Je sais que ça n'y ressemble pas, mais je me suis vraiment débarrassé de nombreuses choses provenant de la pièce annexe.
I looked in my closet for something to wear, but couldn't find anything appropriate for the occasion.	J'ai cherché dans ma garde-robe quelque chose à porter, mais je n'ai rien pu trouver qui convienne à l'occasion.
She advised him to take a long holiday, so he immediately quit work and took a trip around the world.	Elle lui recommanda de prendre de longues vacances, il quitta donc immédiatement le travail et partit en voyage autour du monde.
She advised him to take a long holiday, so he immediately quit work and took a trip around the world.	Elle lui a recommandé de prendre de longues vacances, il a donc quitté immédiatement le travail et est parti en voyage autour du monde.
The natives of the North-West Pacific Coast of America were probably descendants of tribes from Asia.	Les indigènes de la côte américaine nord-ouest du Pacifique étaient probablement les descendants de tribus originaires d'Asie.
"If you're tired, why don't you go to sleep?" "Because if I go to sleep now I will wake up too early."	"Si t'es fatigué, pourquoi ne vas-tu pas dormir ?" "Parce que si j'vais dormir tout de suite, je me réveillerai trop tôt."
Despite the government’s protection, he was the victim of an assassination attempt which killed him.	En dépit de la protection du gouvernement, il fut la victime d'une tentative d'assassinat qui le tua.
Every student of biology, anatomy, anthropology, ethnology or psychology is familiar with these facts.	Tout étudiant en biologie, anatomie, anthropologie, ethnologie ou psychologie est familier de ces faits.
Visible from space, the Great Barrier Reef is the largest structure on Earth made by living organisms.	Visible depuis l'espace, la Grande Barrière de Corail est la plus grande structure sur Terre construite par des organismes vivants.
When you watch television or listen to the radio, the music which you hear is often African in origin.	Lorsque vous regardez la télévision ou écoutez la radio, la musique que vous entendez est souvent d'origine africaine.
You say I should know him quite well, but as a matter of fact, I was introduced to him only last week.	Tu dis que je le connais bien, mais en réalité, on me l'a présenté la semaine dernière.
You should make sure that you get there on time. Tom won't wait more than ten minutes if you are late.	Tu devrais vérifier que tu seras à l'heure. Tom ne t'attendra pas plus de dix minutes.
After the hatchet job my boss did on my proposal, I'm not sure how long I want to keep on working here.	Après le travail d'abattage que le patron a fait sur mes suggestions, je ne suis pas sûr de vouloir travailler encore longtemps ici.
Another interesting source of energy is the heat that can be recovered from radioactive waste material.	Une autre source intéressante d'énergie est la chaleur qui peut être récupérée dans les matériaux à déperdition radioactive.
Disconnect the power cable from the modem, wait for approximately one minute, then reconnect the cable.	Déconnectez l'alimentation du modem, attendez environ une minute, puis connectez de nouveau le câble.
Disconnect the power cable from the modem, wait for approximately one minute, then reconnect the cable.	Déconnecte l'alimentation du modem, attends environ une minute, puis connecte de nouveau le câble.
I never see a library without wishing I had time to go there and stay till I had read everything in it.	Je ne vois jamais une bibliothèque sans souhaiter avoir le temps de m'y rendre et d'y rester jusqu'à ce que j'y aie tout lu.
Next time I switch jobs, I need work that will let me make use of the experience I've gained up to now.	La prochaine fois que je change d'emploi, j'ai besoin d'un travail qui me permettra de mettre à profit l'expérience que j'ai acquise jusqu'à maintenant.
The body and the mind of man are so closely bound together that whatever affects one affects the other.	Le corps et l'esprit de l'homme sont si étroitement liés l'un à l'autre que quoi qu'il arrive à l'un affecte l'autre.
When I visited my hometown this summer, I found the city different from what it had been ten years ago.	En visitant ma ville natale cet été, je l'ai trouvée différente de ce qu'elle était dix ans auparavant.
Between meals, he usually manages to stow away a generous supply of candy, ice cream, popcorn and fruit.	Entre les repas, il s'arrange d'ordinaire pour mettre de côté une abondante réserve de sucreries, de crème glacée, de pop-corn et de fruits.
Poverty does more to bring out the worst in people and conceal the best than anything else in the world.	La pauvreté contribue, plus que toute autre chose au monde, à faire ressortir le pire des gens et à dissimuler le meilleur.
Some people think that it is difficult for a native speaker of English to learn Chinese, but I disagree.	Certains pensent qu'il est difficile pour un anglophone natif d'apprendre le chinois, mais je ne suis pas d'accord.
The world's greatest singers and most of its famous musicians have been fat or at least decidedly plump.	Les plus grands chanteurs du monde et la plupart de ses musiciens renommés, ont été gros ou tout au moins vraiment enrobés.
Tom thinks he knows how much money Mary makes, but Mary makes quite a bit more than Tom thinks she does.	Tom pense savoir combien d'argent Mary gagne, mais Mary se fait bien plus que ce que Tom pense.
When I got out of prison, I couldn't find a job anywhere near my home since no one would hire an ex-con.	Lorsque je suis sorti de prison, je ne pouvais trouver un emploi où que ce soit près de chez moi, car personne ne voulait employer un ex-détenu.
A lot of people would like to become famous. However, a lot of famous people wish they weren't so famous.	Beaucoup de gens voudraient être connus. Cependant, beaucoup de gens célèbres aimeraient ne pas être aussi connus.
During hard times, people might not go on a trip, but they might be willing to pay extra for good coffee.	Quand les temps sont durs, les gens peuvent ne pas partir en voyage mais ils peuvent être disposés à payer davantage pour du café de bonne qualité.
Her sewing basket, dresser drawers and pantry shelves are all systematically arranged in apple-pie order.	Son panier de couture, les tiroirs de son vaisselier et les étagères de son garde-manger sont tous systématiquement ordonnés de manière impeccable.
I'd love to be a fly on the wall at the meeting of the senior executives about the future of the company.	J'aimerais être une petite souris lors de la réunion des dirigeants sur l'avenir de la société.
My friend likes to live in the city, but his wife prefers to live in their little cottage in the country.	Mon ami aime vivre en ville, mais sa femme préfère habiter dans leur petite maison de campagne.
Since there are rice paddies near my house, I often hear frogs croaking all night long this time of year.	Comme il y a des rizières à côté de chez moi, j'entends souvent des grenouilles coasser toute la nuit, à cette époque de l'année.
Some superstitious people in America believe that if a black cat crosses your path, you'll have bad luck.	Certaines personnes superstitieuses en Amérique, croient que si un chat noir croise votre chemin, vous aurez de la malchance.
Thomas A. Edison so loves his work that he sleeps an average of less than four hours of each twenty-four.	Thomas Edison adore tellement son travail qu'il dort en moyenne moins de quatre heures toutes les vingt-quatre heures.
What's important isn't which university you've graduated from, but what you learned while you were there.	L'important, ce n'est pas l'université où tu as obtenu ton diplôme, mais ce que tu as appris lorsque tu y étais.
Last year, I spent so much time by myself that I almost forgot how to communicate effectively with others.	L'année passée, j'ai passé tant de temps tout seul que j'ai presque oublié comment communiquer de manière efficace avec les autres.
Nothing will determine our success as a nation in the 21st century more than how well we educate our kids.	Rien ne déterminera plus notre succès en tant que nation du 21ème siècle que la façon dont nous éduquons nos enfants.
Tom wondered if Mary would think that eight in the morning was too early for him to open a bottle of wine.	Tom se demanda si Mary penserait que huit heures du matin était trop tôt pour qu'il ouvre une bouteille de vin.
We still have more than halfway to go to get to the top of the mountain. Are you really already exhausted?	Nous avons encore plus de la moitié du chemin à parcourir pour atteindre le sommet. Es-tu vraiment déjà fatigué ?
We still have more than halfway to go to get to the top of the mountain. Are you really already exhausted?	Nous avons encore plus de la moitié du chemin à parcourir pour atteindre le sommet. Êtes-vous vraiment déjà fatiguée ?
We still have more than halfway to go to get to the top of the mountain. Are you really already exhausted?	Nous avons encore plus de la moitié du chemin à parcourir pour atteindre le sommet. Êtes-vous vraiment déjà fatiguées ?
We still have more than halfway to go to get to the top of the mountain. Are you really already exhausted?	Nous avons encore plus de la moitié du chemin à parcourir pour atteindre le sommet. Êtes-vous vraiment déjà fatigués ?
When I woke up today, I yawned, stretched, rubbed the sleep out of my eyes, and put on a pair of slippers.	Lorsque je me suis réveillé ce matin, j'ai baillé, me suis étiré, j'ai frotté le sommeil de mes yeux et j'ai enfilé une paire de pantoufles.
Cats are like girls. If they talk to you it's great, but if you try to talk to them, it doesn't go so well.	Les chats sont comme les filles. S'ils vous parlent, c'est super, mais si vous essayez de leur parler, ça ne se passe pas si bien.
Incidentally, this room doesn't have anything like an air conditioner. All it has is a hand-held paper fan.	Du reste, cette pièce n'est pourvue de rien de tel qu'un climatiseur. Tout ce dont elle dispose est un éventail.
Providing energy to the poor without destroying the planet any further is this century's biggest challenge.	Fournir de l'énergie aux pauvres sans continuer à détruire la planète est le plus grand défi de ce siècle.
Give a man a fish and you feed him for a day. Teach a man to fish and you feed him for the rest of his life.	Donne un poisson à un homme, il mangera un jour. Apprends-lui à pêcher, il mangera toute sa vie.
Tom is respected in the business community because he is always fair and square in his dealings with others.	Tom est respecté dans la communauté des affaires parce qu'il est toujours juste et honnête dans ses rapports avec les autres.
Tom told me that Mary was good at playing the piano, but I didn't really believe him until I heard her play.	Tom m'a dit que Mary jouait bien du piano, mais je ne l'ai pas vraiment cru jusqu'à ce que je l'entende jouer.
We can't leave our tents on the beach where they are now. If we do, they'll be under water during high tide.	Nous ne pouvons laisser nos tentes sur la plage où elles sont actuellement. Si nous le faisons, elles se trouveront sous l'eau à la marée haute.
I know it's kind of late, but would you mind if I came over now? I have something I need to discuss with you.	Je sais qu'il est assez tard mais cela te dérangerait-il que je vienne chez toi maintenant ? J'ai quelque chose qu'il me faut discuter avec toi.
I know it's kind of late, but would you mind if I came over now? I have something I need to discuss with you.	Je sais qu'il est assez tard mais cela vous dérangerait-il que je vienne chez vous maintenant ? J'ai quelque chose qu'il me faut discuter avec vous.
If you are a parent, don't allow yourself to set your heart on any particular line of work for your children.	Si vous êtes parent, ne vous laissez pas aller à pencher en direction d'une voie professionnelle particulière pour vos enfants.
The best thing about working in a team is that, when something goes wrong, you can always blame someone else.	Le meilleur aspect du travail en équipe est que si quelque chose va de travers, on peut toujours le mettre sur le dos de quelqu'un d'autre.
A person will have the face of an angel when borrowing something, but the face of the devil when returning it.	Une personne aura le visage d'un ange lorsqu'elle emprunte quelque chose, mais le visage du Diable en le rendant.
I can't believe that you aren't at least willing to consider the possibility that there's another explanation.	Je n'arrive pas à croire que tu ne sois pas disposé à au moins envisager la possibilité qu'il y ait une autre explication.
I can't believe that you aren't at least willing to consider the possibility that there's another explanation.	Je n'arrive pas à croire que vous ne soyez pas disposé à au moins envisager la possibilité qu'il y ait une autre explication.
I can't believe that you aren't at least willing to consider the possibility that there's another explanation.	Je n'arrive pas à croire que tu ne sois pas disposée à au moins envisager la possibilité qu'il y ait une autre explication.
I can't believe that you aren't at least willing to consider the possibility that there's another explanation.	Je n'arrive pas à croire que vous ne soyez pas disposée à au moins envisager la possibilité qu'il y ait une autre explication.
I can't believe that you aren't at least willing to consider the possibility that there's another explanation.	Je n'arrive pas à croire que vous ne soyez pas disposés à au moins envisager la possibilité qu'il y ait une autre explication.
I can't believe that you aren't at least willing to consider the possibility that there's another explanation.	Je n'arrive pas à croire que vous ne soyez pas disposées à au moins envisager la possibilité qu'il y ait une autre explication.
I honestly think it's better to be a failure at something you love than to be a success at something you hate.	Je pense sincèrement qu'il est préférable d'échouer à quelque chose que l'on adore plutôt que d'avoir du succès à quelque chose que l'on déteste.
President Barack Obama praised Poland as an example for aspiring democracies in the Middle East and elsewhere.	Le Président Barack Obama a loué la Pologne comme exemple pour les démocraties en devenir au Moyen-Orient et ailleurs.
We're going to make sure that no one is taking advantage of the American people for their own short-term gain.	Nous allons nous assurer que personne ne tire avantage du peuple étasunien pour son propre profit à court terme.
From the moment he arrived there, he kept on bothering his doctor to tell him when he would be able to go home.	Dès le moment où il est arrivé, il n'arrêtait pas de demander quand est-ce qu'il pourrait partir chez lui.
I realize I may not be the most desirable man in the world, but I still hope you'll consider going out with me.	Je me rends compte que je ne suis peut-être pas l'homme le plus séduisant du monde mais j'espère quand même que vous envisagerez de sortir avec moi.
I realize I may not be the most desirable man in the world, but I still hope you'll consider going out with me.	Je me rends compte que je ne suis peut-être pas l'homme le plus séduisant du monde mais j'espère quand même que tu envisageras de sortir avec moi.
People often lie about what they did on the weekend, so their friends won't realize how boring they really are.	Les gens mentent souvent à propos de ce qu'ils font de leur week-end pour que leurs amis ne réalisent pas combien leur vie est ennuyeuse.
The police suspected there was a connection between the abandoned car and the dead body found three miles away.	Les policiers soupçonnaient qu'il existait un lien entre la voiture abandonnée et le cadavre trouvé trois kilomètres plus loin.
The questions came fast and furious from the large number of reporters who had gathered outside the courthouse.	Les questions fusèrent de la part du grand nombre de journalistes qui s'étaient assemblés à l'extérieur du tribunal.
A few people mentioned they would like to attend some sessions later in the day on the Technical Session Agenda.	Certaines personnes ont mentionné qu'elles aimeraient assister à certaines sessions plus tard dans la journée sur l'Ordre du jour des Sessions Techniques.
Consider the successes that have been achieved by tired, discouraged people who decided to give it one more try.	Regarde les succès qu'ont eu des gens fatigués et découragés qui ont pris la décision d'essayer une dernière fois.
Consider the successes that have been achieved by tired, discouraged people who decided to give it one more try.	Regardez les succès qu'ont eu des gens fatigués et découragés qui ont pris la décision d'essayer une dernière fois.
I know that it is highly unlikely that you'd ever want to go out with me, but I still need to ask at least once.	Je sais qu'il est hautement improbable que tu veuilles jamais sortir avec moi, mais j'ai tout de même besoin de demander au moins une fois.
The man who makes but one mistake a year because he makes but two decisions is wrong fifty per cent of the time.	L'homme qui commet une erreur par an parce qu'il ne prend que deux décisions, se trompe cinquante pour cent du temps.
I know you're upset about your car being totaled, but you weren't injured and you should be thankful to be alive.	Je sais que tu es contrarié que ta voiture soit bonne pour la casse, mais tu n'as pas été blessé et tu devrais être heureux d'être en vie.
I sometimes wish I could live a quiet retired sort of life but I doubt I could stand it for more than a few days.	Parfois je souhaiterais vivre une sorte de vie calme et retraitée mais je doute que je puisse la supporter plus de quelques jours.
Did you know that in Japan, if you have a tattoo, you won't be allowed to bathe in many of the hot spring resorts?	Saviez-vous qu'au Japon, si vous portez un tatouage, vous ne serez pas autorisé à vous baigner dans beaucoup des stations thermales ?
He is inclined to look at everything from the standpoint of its practicality and is neither stingy nor extravagant.	Il a tendance à considérer toute chose sous un angle pratique et n'est ni avare ni prodigue.
Someone told me that Albert Einstein said, "Common sense is the collection of prejudices acquired by age eighteen."	Quelqu'un m'a dit qu'Albert Einstein déclara : "Le bon sens est la collection des préjugés acquis à l'âge de dix-huit ans."
Every time I make a mistake, I learn something. The challenge is not to keep making the same mistakes over and over.	Chaque fois que je commets une erreur, j'apprends quelque chose. Le défi est de ne pas continuer à toujours commettre les mêmes erreurs.
Getting your message across is much more important than trying to say it exactly like a native speaker would say it.	Véhiculer votre message est bien plus important que d'essayer de le dire exactement comme un locuteur natif le dirait.
I felt bad, so I was admitted into the hospital. However, it turned out that there was nothing really wrong with me.	Je me sentais mal, aussi je fus admis à l'hôpital. Cependant, il s'avéra qu'il n'y avait rien qui n'allait réellement pas chez moi.
Not long ago we heard a father say in the presence of his large family, "I don't want any of my boys to be lawyers."	Il n'y a pas si longtemps, nous entendîmes un père, dire en présence de sa famille étendue : « Je veux qu'aucun de mes garçons ne soit avocat. »
Notice the hands of the people you meet and you will be surprised to see how different and how interesting they are.	Remarquez les mains des gens que vous rencontrez et vous serez surpris de constater combien elles diffèrent et comme elles sont intéressantes.
The police drew an outline of a body at the scene of the crime to indicate how the body was lying when it was found.	La police traça le contour d'un corps, sur le lieu du crime, pour indiquer comment le cadavre était étendu, lorsqu'il avait été trouvé.
This is a time of year when people get together with family and friends to observe Passover and to celebrate Easter.	C'est le moment de l'année auquel les gens se réunissent avec leur famille et leurs amis pour célébrer Pessa'h et fêter la Pâques.
A man touched down on the moon. A wall came down in Berlin. A world was connected by our own science and imagination.	Un homme a atterri sur la lune. Un mur a été abattu à Berlin. Un monde a été connecté par notre propre science et notre imagination.
Charles Moore created Forth in an attempt to increase programmer productivity without sacrificing machine efficiency.	Charles Moore a créé le Forth dans une tentative pour accroître la productivité du programmeur sans sacrifier l'efficacité de la machine.
Every student who has graduated from our university has studied English with a native speaker for at least two years.	Tous les étudiants qui ont été diplômés de notre université ont étudié l'anglais avec un locuteur natif pendant au moins deux ans.
If you don't want to put on sunscreen, that's your problem. Just don't come complaining to me when you get a sunburn.	Si tu ne veux pas mettre de crème solaire c'est ton problème, mais ne viens pas te plaindre quand t'auras des coups de soleil.
Nobody has asked you to agree, but can't you at least accept that there are people who hold different views from you?	Personne ne t'a demandé d'être d'accord, mais ne peux-tu pas, au moins, accepter qu'il y a des gens qui ont un point de vue différent du tien ?
Nobody has asked you to agree, but can't you at least accept that there are people who hold different views from you?	Personne ne vous a demandé d'être d'accord, mais ne pouvez-vous pas, au moins, accepter qu'il y a des gens qui ont un point de vue différent du vôtre ?
The people crowded round the injured man, but they made way for the doctor when he reached the scene of the accident.	Les gens s'attroupèrent autour du blessé, mais firent place au médecin quand il atteignit le lieu de l'accident.
A chance to do as we please, especially to do as little hard work as possible, is a secret desire of almost everybody.	Une occasion de faire ce qui nous plait, en particulier de faire aussi peu de travail pénible que possible, est le désir secret de presque tout le monde.
Even though computer programmers may use semicolons every day, nowadays most people only use semicolons for emoticons.	Bien que les programmeurs utilisent quotidiennement les points-virgules, la plupart des gens les utilisent de nos jours seulement pour les émoticônes.
I had never eaten any kind of Thai food, so I was pretty excited about going to a Thai restaurant with my grandmother.	Je n'avais jamais mangé aucune sorte de nourriture thaï alors j'étais assez excité d'aller dans un restaurant thaï avec ma grand-mère.
Since I've been on this diet, my weight is down, my cholesterol is down and my sleep apnea has completely disappeared.	Depuis que je suis ce régime, j'ai perdu du poids, mon cholestérol a baissé et mon apnée du sommeil a complètement disparu.
"When does your sister come back from work?" "I don't know, but I think she'll arrive at home a few minutes before me."	"-Quand ta sœur rentre-t-elle du travail ?" "-Je ne sais pas, mais je pense qu'elle arrivera à la maison quelques minutes avant moi."
Never choose a vocation just because your friends are in it, nor refuse another just because your worst enemy is in it.	Ne choisissez jamais une vocation juste parce que vos amis s'y trouvent, pas plus que n'en refusez une autre juste parce que s'y trouve votre pire ennemi.
When we hear of a divorce we assume that it was caused by the inability of those two people to agree upon fundamentals.	Lorsque nous entendons parler d'un divorce, nous supposons qu'il a été causé par l'incapacité de ces deux personnes à s'entendre sur les fondamentaux.
Even now, I occasionally think I'd like to see you. Not the you that you are today, but the you I remember from the past.	Même maintenant, je pense parfois que j'aimerais te voir. Pas la personne que tu es aujourd'hui, mais celle dont je me rappelle.
Police are urging people not to pick up hitchhikers as they search for two prisoners on the run after escaping from jail.	La police exhorte les gens à ne pas prendre d'autostoppeurs car ils recherchent deux prisonniers en cavale après leur évasion.
We should spend our time creating content for our website rather than wasting time worrying about minor cosmetic details.	Nous devrions consacrer notre temps à créer du contenu pour notre site web plutôt que de gâcher du temps à nous préoccuper de détails esthétiques mineurs.
A lot of people who have up until now been spending money having a good time now need to be more careful with their money.	Beaucoup de gens qui ont jusqu'à présent dépensé de l'argent à passer du bon temps doivent être plus prudents avec leur argent.
For the crime of first degree murder, this court hereby sentences you to life in prison without the possibility of parole.	Pour le crime de meurtre au premier degré, cette cour vous condamne à la prison à perpétuité, sans possibilité de remise de peine.
It's very easy to sound natural in your own native language, and very easy to sound unnatural in your non-native language.	Il est très aisé d'avoir l'air naturel dans votre langue natale et très aisé d'avoir l'air de manquer de naturel dans une autre langue.
The difference between the right word and almost the right word is the difference between lightning and the lightning bug.	La différence entre un « mot juste » et un « mot presque juste » est comme la différence entre la foudre et le foudre.
The difference between the right word and almost the right word is the difference between lightning and the lightning bug.	La différence entre un « mot juste » et un « mot presque juste » est comme la différence entre un éclair et un éclair au chocolat.
If you don't eat breakfast, you'll probably be hungry during the morning and won't be as efficient at work as you could be.	Si tu ne petit-déjeunes pas, tu auras probablement faim au cours de la matinée et tu ne seras pas aussi efficace au travail que tu pourrais l'être.
If you don't eat breakfast, you'll probably be hungry during the morning and won't be as efficient at work as you could be.	Si vous ne petit-déjeunez pas, vous aurez probablement faim au cours de la matinée et vous ne serez pas aussi efficace au travail que vous pourriez l'être.
I used to watch this anime a lot when I was a kid, but I can't quite remember what happened to the hero in the final episode.	J'avais l'habitude de beaucoup regarder ce dessin animé quand j'étais enfant, mais je ne peux plus trop me rappeler ce qui est arrivé au héros dans l'ultime épisode.
The English language is undoubtedly the easiest and at the same time the most efficient means of international communication.	La langue anglaise est indubitablement la plus facile et en même temps le moyen de communication internationale le plus efficace.
According to the contract you may take three days of bereavement leave for your uncle's funeral, but only one for your nephew's.	Conformément au contrat, vous pouvez prendre trois jours de congé de deuil pour les funérailles de votre oncle, mais un seul pour celles de votre neveu.
According to the contract you may take three days of bereavement leave for your uncle's funeral, but only one for your nephew's.	Conformément aux closes du contrat, vous pouvez prendre trois jours de congé de deuil pour les funérailles de votre oncle, mais un seul pour celles de votre neveu.
According to the contract you may take three days of bereavement leave for your uncle's funeral, but only one for your nephew's.	Conformément au contrat, vous pouvez prendre trois jours de congé de décès pour les funérailles de votre oncle, mais un seul pour celles de votre neveu.
Food prices are at their highest level since the United Nations Food and Agriculture Organization began keeping records in 1990.	Les prix de l'alimentation sont à leur plus haut niveau depuis que l'Organisation des Nations Unies pour l’alimentation et l’agriculture a commencé à les enregistrer en mille-neuf-cent-quatre-vingt-dix.
If one has the right to live, then one should also have the right to die. If not, then living is not a right, but an obligation.	Si quelqu'un détient le droit de vivre, alors il devrait également détenir celui de mourir. Sinon, vivre n'est alors pas un droit mais une obligation.
It was bad enough that he usually came to work late, but coming in drunk was the last straw, and I'm going to have to let him go.	C'était suffisamment grave qu'il arrive habituellement au travail en retard, mais venir soûl est un comble, et je vais devoir m'en débarrasser.
The teacher supervising the playground became concerned when she saw a man talking to some of the children over the school fence.	L'institutrice chargée de surveiller la courre s'inquiéta lorsqu'elle vit un homme parler à des enfants par-dessus la grille de l'école.
Cities and provinces along the Yangtze River in central China are grappling with the country's worst drought in more than 50 years.	Les villes et les provinces le long du fleuve Yangtsé, au centre de la Chine, sont aux prises avec la pire sécheresse que le pays ait connu depuis plus de cinquante ans.
That proposal may be a way to kill two birds with one stone, but we also have to be careful not to get greedy and spoil everything.	Cette proposition pourrait faire d'une pierre deux coups, mais nous devons aussi faire attention à ne pas devenir gourmands et ainsi tout gâcher.
A committee is a group of people who individually can do nothing, but who, as a group, can meet and decide that nothing can be done.	Un comité est un groupe de gens qui ne peuvent rien faire individuellement mais qui peuvent tenir des réunions en tant que groupe et parvenir à la décision qu'on ne peut rien faire.
One of the best ways to help us is to translate from a foreign language you know into your own native language or strongest language.	L'une des meilleures manières de nous aider est de traduire d'une langue étrangère que vous connaissez vers votre propre langue natale, ou la plus forte de vos langues.
Since it will be cold soon, it might be nice to enjoy doing something outdoors the final few warm days we have before winter sets in.	Puisqu'il fera bientôt froid, ça serait chouette de profiter des quelques derniers jours chauds dont nous disposons pour faire quelque chose à l'extérieur, avant que l'hiver ne s'installe.
A man who has never gone to school may steal from a freight car, but if he has a university education, he may steal the whole railroad.	Un homme qui n'a jamais été à l'école peut voler d'un wagon, mais s'il dispose d'un diplôme, il peut voler toute la ligne de chemin de fer.
One way to lower the number of errors in the Tatoeba Corpus would be to encourage people to only translate into their native languages.	Un moyen de diminuer le nombre d’erreurs dans le corpus de Tatoeba serait d’encourager les gens à traduire uniquement vers leur langue maternelle.
What is old age? First you forget names, then you forget faces, then you forget to pull your zipper up, then you forget to pull it down.	Qu'est l'âge ? D'abord on oublie les noms, et puis on oublie les visages, puis on oublie de remonter sa braguette, et puis on oublie de la descendre.
What is old age? First you forget names, then you forget faces, then you forget to pull your zipper up, then you forget to pull it down.	Ce qu'est l'âge ? D'abord on oublie les noms, et puis on oublie les visages, puis on oublie de remonter sa braguette, et puis on oublie de la descendre.
He and I have a near-telepathic understanding of each other. No sooner does one of us say something than the other is already responding.	Lui et moi avons une compréhension quasi-télépathique de chacun. Aussitôt que l'un de nous dit quelque chose, l'autre est déjà en train de répondre.
Although rainforests make up only two percent of the earth's surface, over half the world's wild plant, animal and insect species live there.	Bien que les forêts tropicales ne couvrent que 2% de la surface de la terre, plus de la moitié des espèces animales, végétales et des insectes y vivent.
If you translate from your second language into your own native language, rather than the other way around, you're less likely to make mistakes.	Si vous traduisez de votre seconde langue dans votre propre langue maternelle, plutôt que dans l'autre sens, il y a moins de chances que vous commettiez des fautes.
I love trying out new things, so I always buy products as soon as they hit the store shelves. Of course, half the time I end up wishing I hadn't.	J'adore essayer de nouvelles choses, alors j'achète toujours des produits dès qu'ils sont en rayons. Bien sûr, la moitié du temps, je finis par souhaiter ne pas l'avoir fait.
A good theory is characterized by the fact that it makes a number of predictions that could in principle be disproved or falsified by observation.	Une bonne théorie se caractérise par le fait de faire une série de prédictions qui, en principe, pourraient être réfutées ou mises en défaut par l'observation.
The more time you spend speaking a foreign language, the better you get at guessing what non-native speakers are trying to say in your own language.	Plus l'on passe de temps à parler une langue étrangère, plus l'on s'améliore à devenir ce qu'un non-natif essaie de dire dans sa propre langue.
The enquiry concluded that, despite his denials, the chief executive would have had to have known about the illegal practices occurring in the company.	L'enquête conclut qu'en dépit de ses dénégations, le directeur général aurait eu connaissance des pratiques illégales, en cours dans l'entreprise.
The Tatoeba Project, which can be found online at tatoeba.org, is working on creating a large database of example sentences translated into many languages.	Le projet Tatoeba, que l'on peut trouver en ligne sur tatoeba.org, travaille à la création d'une vaste base de données de phrases d'exemple, traduites dans de nombreuses langues.
You may not learn to speak as well as a native speaker, but you should be able to speak well enough that native speakers will understand what you have to say.	Peut-être n'apprendrez-vous pas à parler comme un locuteur natif, mais vous devriez être en mesure de parler suffisamment bien pour que les natifs comprennent ce que vous avez à dire.
E-cigarettes are being promoted as a healthy alternative to tobacco cigarettes, but health authorities are concerned about the long-term health effects on users.	La cigarette électronique est mise en avant comme une saine alternative aux cigarettes, mais les autorités sanitaires s'inquiètent des effets à long terme sur la santé des consommateurs.
It's still too hard to find a job. And even if you have a job, chances are you're having a tougher time paying the rising costs of everything from groceries to gas.	C'est encore trop difficile de trouver un emploi. Et même quand on en a un, il y a des chances qu'on ait davantage de difficultés à payer le coût de tout, de l'épicerie au gaz.
As you contribute more sentences to the Tatoeba Corpus in your native language, the percentage of sentences in your native language with errors will likely decrease.	Au fur et à mesure que vous ajoutez davantage de phrases au corpus de Tatoeba dans votre langue natale, il est probable que le pourcentage de phrases dans celle-ci, comportant des erreurs, diminuera.
Even at the end of the nineteenth century, sailors in the British Navy were not permitted to use knives and forks because using them was considered a sign of weakness.	Même à la fin du dix-neuvième siècle, les marins de la marine britannique n'étaient pas autorisés à utiliser des couteaux et des fourchettes parce que c'était considéré comme un signe de faiblesse.
Five tremors in excess of magnitude 5.0 on the Richter scale have shaken Japan just this week, but scientists are warning that the largest expected aftershock has yet to hit.	Cinq secousses dépassant la magnitude cinq sur l'échelle de Richter ont secoué le Japon précisément cette semaine, mais les scientifiques avertissent que la plus grande réplique est encore à venir.
No matter how much you try to convince people that chocolate is vanilla, it'll still be chocolate, even though you may manage to convince yourself and a few others that it's vanilla.	Peu importe le temps que tu passeras à essayer de convaincre les gens que le chocolat est de la vanille, ça restera toujours du chocolat, même si tu réussis à convaincre toi et quelques autres que c'est de la vanille.
A child who is a native speaker usually knows many things about his or her language that a non-native speaker who has been studying for years still does not know and perhaps will never know.	Un enfant qui est un locuteur natif connaît habituellement de nombreuses choses sur son langage qu'un locuteur non-natif qui a étudié pendant des années ignore encore et peut-être ne saura jamais.
There are four main causes of alcohol-related death. Injury from car accidents or violence is one. Diseases like cirrhosis of the liver, cancer, heart and blood system diseases are the others.	Il y a quatre causes principales de décès liés à l'alcool. Les blessures dans les accidents automobiles ou la violence en est une. Les maladies comme la cirrhose, le cancer, les maladies cardio-vasculaires en sont les autres.
"Top-down economics never works," said Obama. "The country does not succeed when just those at the very top are doing well. We succeed when the middle class gets bigger, when it feels greater security."	« L'économie en partant du haut vers le bas, ça ne marche jamais, » a dit Obama. « Le pays ne réussit pas lorsque seulement ceux qui sont au sommet s'en sortent bien. Nous réussissons lorsque la classe moyenne s'élargit, lorsqu'elle se sent davantage en sécurité. »
A carbon footprint is the amount of carbon dioxide pollution that we produce as a result of our activities. Some people try to reduce their carbon footprint because they are concerned about climate change.	Une empreinte carbone est la somme de pollution au dioxyde de carbone que nous produisons par nos activités. Certaines personnes essaient de réduire leur empreinte carbone parce qu'elles sont inquiètes du changement climatique.
Death is something that we're often discouraged to talk about or even think about, but I've realized that preparing for death is one of the most empowering things you can do. Thinking about death clarifies your life.	La mort est une chose qu'on nous décourage souvent de discuter ou même de penser mais j'ai pris conscience que se préparer à la mort est l'une des choses que nous puissions faire qui nous investit le plus de responsabilité. Réfléchir à la mort clarifie notre vie.
Since there are usually multiple websites on any given topic, I usually just click the back button when I arrive on any webpage that has pop-up advertising. I just go to the next page found by Google and hope for something less irritating.	Puisqu'il y a de multiples sites web sur chaque sujet, je clique d'habitude sur le bouton retour arrière lorsque j'atterris sur n'importe quelle page qui contient des publicités surgissantes. Je me rends juste sur la prochaine page proposée par Google et espère tomber sur quelque chose de moins irritant.
If someone who doesn't know your background says that you sound like a native speaker, it means they probably noticed something about your speaking that made them realize you weren't a native speaker. In other words, you don't really sound like a native speaker.	Si quelqu'un qui ne connaît pas vos antécédents dit que vous parlez comme un locuteur natif, cela veut dire qu'il a probablement remarqué quelque chose à propos de votre élocution qui l'a fait prendre conscience que vous n'êtes pas un locuteur natif. En d'autres termes, vous ne parlez pas vraiment comme un locuteur natif.
It may be impossible to get a completely error-free corpus due to the nature of this kind of collaborative effort. However, if we encourage members to contribute sentences in their own languages rather than experiment in languages they are learning, we might be able to minimize errors.	Il est peut-être impossible d'obtenir un Corpus complètement dénué de fautes, étant donnée la nature de ce type d'entreprise collaborative. Cependant, si nous encourageons les membres à produire des phrases dans leurs propres langues plutôt que d'expérimenter dans les langues qu'ils apprennent, nous pourrions être en mesure de réduire les erreurs.
